11111111111
11110C01111
11110001111
11110000111
11110001111
10000000001
1C0000000E1
10000000001
11110001111
11110001111
111100P1111
11111111111
