1111111111
1P0C0000E1
1011000111
1010C00011
1000010001
1000111CC1
10CC01C001
1010000011
1C1100C111
1111111111
